barrel=бочка
bamboo=бамбук
bed=кровать
bone block=костный блок
cobblestone=булыжник
craft table=верстак
dark oak planks=темные дубовые доски
dark oak wood=темное дубовое бревно
diorit=диорит
fallen sakura flower=упавшие цветы сакуры
furnace=печь
glass azure=стекло лазурное
glass black=стекло черное
glass blue=стекло синее
glass gray=стекло серое
glass green=стекло зеленое
glass red=стекло красное
glass turquoise=стекло бирюзовое
glass white=стекло белое
glass yellow=стекло желтое
granit=гранит
granit brick=гранитный кирпич
gravel=гравий
ice=лед
iron ore=железная руда
limestone=известняк
pipe=трубка
andesit=андезит
polished andesit=отполированный андезит
polished diorit=отполированный диорит
polished granit=отполированный гранит
rooted dirt=укоренившаяся земля
sakura leaves=листья сакуры
white sakura leaves=белые листья сакуры
sakura planks=доски сакуры
sakura wood=бревно сакуры
slate=сланец
snow=снег
snow block=снежный блок
snow grass=снежная трава
snow plate=снежная плита
snow slab=снежный полублок
spinal bone=спинной мозг
spruce leaves=еловые листья
spruce planks=еловые доски
spruce wood=еловое бревно
teak leaves=тиковые листья
teak planks=тиковые доски
teak wood=тиковое бревно
tuff=туф
water=вода
wet dirt=влажная земля
whitesakuraleaves=белые листья сакуры
withered bush=засохший куст
wool black=черная шерсть
wool blue=синяя шерсть
wool brown=коричневая шерсть
wool gray=серая шерсть
wool green=зеленая шерсть
wool red=красная шерсть
wool white=белая шерсть
wool yellow=желтая шерсть
flint=кремний
iron axe=железный топор
iron ingot=железный слиток
iron pickaxe=железная кирка
kuppel=кублоко
spawner=спавнер
stick=палка
stone axe=каменный топор
stone pickaxe=каменная кирка
string=нить
wooden axe=деревянный топор
wooden pickaxe=деревянная кирка
yellow dye=желтый краситель